NO ./asset/stone.png
SO ./asset/wall.png
WE ./asset/Stones_Texture.png
EA ./asset/Brickwall6_Texture.png
F 255,255,255
C 0,0,0


        1111111111111111111111111
        1000000000110000000000001
        1011000001110000000000001
        1001000000000000000000001
111111111011000001110000000000001
100000000011000001110111111111111
11110111111111011100000010001
11110111111111011101010000001
11000000110101011100000010001
10000000000000001100000010001
10000000000000001101010010001
11000001110101011111011110N011
11110111 1110101 101111010001
11111111 1111111 111111111111