NO ./path_to_the_north_texture
SO ./path_to_the_south_texture
WE ./path_to_the_west_texture
EA ./path_to_the_east_texture
F 220,101,0
C 225,30,0


        1111111111111111111111111
        1000000000110000000000001
        101100000111000000N000001
        1001000000000000000000001
        111111111111111111111110
