NO ./asset/stone.png
SO ./asset/wall.png
WE ./asset/Stones_Texture.png
EA ./asset/Brickwall6_Texture.png
F 153,76,0
C 32,32,32

11111111111
10000100001
1N000100001
10000100001
11111111111