NO ./asset/stone.png
SO ./asset/wall.png
WE ./asset/Stones_Texture.png
EA ./asset/Brickwall6_Texture.png
F 153,76,0
C 32,32,32

111111111
1000000011111111111111111
1E00000000110000000000001
1011000001110000000000001
1001000000000000000000001
1111111111111111111111111